11111111111111111141
10000000000100000001
10111111110101110101
10100000000000010111
10101111111111010001
10101000000001011111
10111011111101000101
10001000000101111101
10101111000100010001
10101001011111010111
10101001010001010001
10101011010101010111
10100000010100010001
11111111110111111101
10000000010100000001
10111111010101011111
10100010000101010001
10101010111101011101
10101000000001000001
13111111111111111111