11111111111111111111
11111111111111111111
11111111111111111111
11000000000000000011
11000000000000000011
11000000000000000011
11000000000000000011
11000000000000000011
11000000000000000011
33000000000000000044
33000000000000000044
11000000000000000011
11000000000000000011
11000000000000000011
11000000000000000011
11000000000000000011
11000000000000000011
11111111111111111111
11111111111111111111
11111111111111111111