11111111111111111111
10001000100010001011
10101010101010101011
10101010101010101011
10101010101010101011
10101010101010101011
10101010101010101011
10101010101010101011
10101010101010101011
30100010001000100044
30100010001000100044
10101010101010101011
10101010101010101011
10101010101010101011
10101010101010101011
10101010101010101011
10101010101010101011
10101010101010101011
10001000100010001011
11111111111111111111