11111111111111111111
30000000000000000001
30000000000000000001
11111111111111111101
10000000000000000001
10111111111111111111
10000000000000000001
11111111111111111101
10000000000000000001
10111111111111111111
10000000000000000001
11111111111111111101
10000000000000000001
10111111111111111111
10000000000000000001
11111111111111111101
10000000000000000001
10111111111111111111
10000000000000000004
11111111111111111111